1110101010111111110101011111
0212221212222222912121213220
1211121211111112112121212121
1222221212222212122121212121
1211111212111212121221212121
1212222212121212121211212121
1212111112121222221222212221
1212132222121112111111111111
0212121112122222122322122220
1112121222221111121112121111
0222121212111222122222122120
1111121212122212111211112121
1222221212121112221222222121
1211111222222221121212112121
1212222211114122221212212121
0222111221015111111211212120
1111111121114111222222222121
1222223122222222212111112121
1211112111211211112221612121
1222212122222222222121412121
1111212121121112111121012121
0222212122221222222222222120
1111212111121211211111111111
1122212122221222212222222221
1144112121211111212111111121
1178112121222322212122232221
1111122121121111212121111111
0222121222122222212121222220
1110101010111111110101011111
