1110101010111111110101011111
3212221212222222212121212420
1211121211111112112121212121
1222221212224212122121212121
1211111212111212121221212121
1512222212121212121211212121
1212111112121222221222512221
1212122222121112111111111111
0212121112122222122222122220
1112121222221111121112121111
0222121212111222122222122120
1111121212122212111211112121
1222221212121112221222222121
1211111222222221121212112121
1212222211112122221212212121
0222111221012111111211212120
1111111121112111222222222121
1222222122222222212111112121
1211112111211211112221212121
1222212122222222222121212121
1111212121121112111121012121
0222212122221222222222222120
1111212111121211211111111111
1122212122221222212222222221
1122112121211111212111111121
1122112121222222212122222221
1111122121121111212121111111
0222121222122225212121422220
1110101010111111110101011111
