1111111111111111111111111111
1422222222222222222222222241
1111211121115111511121112111
1111211121112111211121112111
1222222222222222222222222221
1211112111121111121111111211
1211112111121111121111111211
1211112111121111121111111211
1222222222222222222222222221
1211111111112111211111111121
1222211111112111211111122221
1111212222222111222222121111
1111212111111111111112121111
1222212222222442222222122221
1211212111111111111112121121
1211212222222222222222121121
1211211111111111111111121121
1222222222222322222222222221
1211111211111211121111121121
1215551211111211121555121121
1215551211111211121555121121
1215551211111211121555121121
1211111211111211121111121121
1222222222222522222222222221
1211111211111111121111111121
1211111222222222221111111121
1211111211111111121111111121
1422222222222522222222222241
1111111111111111111111111111
