1111111111110110111111111111
1222222225222112222222222221
1211112111112112111112111121
1210012100012112100012100121
1210012100012112100012100121
1211112111112112111112111121
1222222242222222222222522221
1211112112111111112112111121
1211112112111111112112111121
1222222112222112222112222221
1111112111112112111112111111
0000012111112112111112100000
0000012114222222222112100000
0000012112111111112112100000
1111112112100000012222111111
0002222222111111112112222000
1111112112222222224112111111
0000012112111111112112100000
1111112112111111112112111111
1222222222222112222222222221
1211112111112112111112111121
1211112111112112111112111121
1222112222222322222222112221
1112112112111111112112112111
1112112112111111112112112111
1222222112222112222112422221
1211111111112112111111111121
1222422222222222222222225221
1111111111110110111111111111
